SHHHHHHHHHHHHHS
V CCBCCCCCBCC V
THLCCCCBCCCCLHT
VBV CCCCCCC VBV
VCLHLCCCCCLHLCV
VCCBV CCC VBCCV
VCCCLHLCLHLCCCV
VCCCC V V CCCCV
VCCCCCV VCCCCCV
SHHHHHTHTHHHHHS