SLBCCCCBCCCCBLS
CV  CCCCCCC  VC
CLHL CCCCC LHLC
C  V  CCC  V  C
   LHL C LHL   
  B  V B V  B  
  C  VCCCV  C  
 CCC LHTHL CCC 
CCCCC CVC CCCCC
CCCCC CSC CCCCC