SHHHHL  B B  LS
 CC  V       V 
 CC  V CCCCC V 
BCCB V CCCCC V 
CCCC V       V 
CCCC V B  LHHL 
 CC  V CC V    
 BB  VCCCCV CC 
C    V CC V CC 
CC   LHHHHL    