SHHHHHHTHHHHHHS
VBCCCCBVCCCCCCV
VCCCCCCV CCBC V
V CCCC VCCBCCCV
VCCCCCCV CCCC V
V CCCC VBCCCCCV
VCCBCCCV CCCC V
V CCBC VCCCCCCV
VCCCCCCVCCCCCCV
SHHHHHHTHHHHHHS