SHHHHTHTHTHHHHS
VCBCCV V VCCBCV
VCCC VBVBV CCCV
VCCCLL V LLCCCV
VCC V CVC V CCV
VCCLL CVC LLCCV
VC V CCVCC V CV
VCLLBCCVCCBLLCV
VCVCCCCVCCCCVCV
SHTHHHHTHHHHTHS