SLCCCCCSCCCCCLS
 VCBCBCVCBCBCV 
BVCCCCCVCCCCCVB
CLLCCCCVCCCCLLC
CCV CCCVCCC VCC
CCLHLCCVCCLHLCC
CCCCV CVC VCCCC
CCCCLL V LLCCCC
CCCCCV V VCCCCC
CCCCCLHTHLCCCCC