SHHHLB B BLHHHS
CC  V C C V BB 
C   V C C V CC 
 BB V C C VCCCC
CCCCV C C VCCCC
CCCCLHHTHHL CC 
 CC  C V C  CC 
 CC  C V C     
C    C V C    C
CC   C S C   CC